あいどっく	合いドック	名詞	maritime-terms	
あくせすはっち	アクセスハッチ	名詞	maritime-terms	
あげつみ	揚げ積み	名詞	maritime-terms	
あげしお	上げ潮	名詞	maritime-terms	
あげにやく	揚げ荷役	名詞	maritime-terms	
あしぶね	葦船	名詞	maritime-terms	
あーすばー	アースバー	名詞	maritime-terms	
あてかじ	当舵	名詞	maritime-terms	
あっぺんだうんあんかー	アッペンダウンアンカー	名詞	maritime-terms	
あとぶね	後船	名詞	maritime-terms	
あばんだんせんげん	アバンダン宣言	名詞	maritime-terms	
あふたーぴーくたんく	アフターピークタンク	名詞	maritime-terms	
あぶら	油	名詞	maritime-terms	
あぶらきろくぼ	油記録簿	名詞	maritime-terms	
あぶらしょりざい	油処理剤	名詞	maritime-terms	
あぶろぐ	アブログ	名詞	maritime-terms	
あまぞく	海人族	名詞	maritime-terms	
あゆみいた	歩み板	名詞	maritime-terms	
あらいあんす	アライアンス	名詞	maritime-terms	
あるぱー	アルパー	名詞	maritime-terms	
あれーじほーる	アレージホール	名詞	maritime-terms	
あわしょうかそうち	泡消火装置	名詞	maritime-terms	
あんかーうぇい	アンカーアウェイ	名詞	maritime-terms	
あんしょう	暗礁	名詞	maritime-terms	
あんぜんかじゅう	安全荷重	名詞	maritime-terms	
あんぜんかんりきてい	安全管理規定	名詞	maritime-terms	
あんしゃ	暗車	名詞	maritime-terms	
あんぜんこうぐ	安全工具	名詞	maritime-terms	
あんぜんなそくりょく	安全な速力	名詞	maritime-terms	
いおうさんかぶつ	硫黄酸化物	名詞	maritime-terms	
いかり	錨	名詞	maritime-terms	
いきあいせんのこうほう	行会い船の航法	名詞	maritime-terms	
いきあし	行き脚	名詞	maritime-terms	
いきあしをなくす	行行き脚をなくす	名詞	maritime-terms	
いたくせん	委託船	名詞	maritime-terms	
いちばんせん	一番船	名詞	maritime-terms	
いったいがたけんぞうほう	一体型建造法	名詞	maritime-terms	
いっぱんはいちず	一般配置図	名詞	maritime-terms	
いど	緯度	名詞	maritime-terms	
いーぶんきーる	イーブンキール	名詞	maritime-terms	
いなーとがす	イナートガス	名詞	maritime-terms	
いねむりぼうしそうち	居眠り防止装置	名詞	maritime-terms	
いまーしょんすーつ	イマーションスーツ	名詞	maritime-terms	
いりはまけん	入浜権	名詞	maritime-terms	
いりふね	入船	名詞	maritime-terms	
いんかてん	引火点	名詞	maritime-terms	
いんこたーむず	インコタームズ	名詞	maritime-terms	
いんじけーたこっく	インジケータコック	名詞	maritime-terms	
いんしでんと	インシデント	名詞	maritime-terms	
いんてぐれいてっどぶりっじしすてむ	インテグレイテッドブリッジシステム	名詞	maritime-terms	
いんまるさっと	インマルサット	名詞	maritime-terms	
うぃんどらす	ウィンドラス	名詞	maritime-terms	
うえざーさいど	ウエザーサイド	名詞	maritime-terms	
うぇす	ウェス	名詞	maritime-terms	
うえるでぃんぐぽんぷ	ウエルディングポンプ	名詞	maritime-terms	
うぉーたーかーてん	ウォーターカーテン	名詞	maritime-terms	
うきどっく	浮ドック	名詞	maritime-terms	
うげん	右舷	名詞	maritime-terms	
うずまきぽんぷ	うず巻きポンプ	名詞	maritime-terms	
うねり	うねり	名詞	maritime-terms	
うねりかいきゅう	うねり階級	名詞	maritime-terms	
うみかぜ	海風	名詞	maritime-terms	
うんてんふじゆうせん	運転不自由船	名詞	maritime-terms	
えあーどらふと	エアードラフト	名詞	maritime-terms	
えあーはっち	エアーハッチ	名詞	maritime-terms	
えいしゅせん	Ａ種船	名詞	maritime-terms	
えいせいこうほう	衛星航法	名詞	maritime-terms	
えいせん	曳船	名詞	maritime-terms	
えきたいかがくやくひん	液体化学薬品	名詞	maritime-terms	
えきめんけい	液面計	名詞	maritime-terms	
えこーさうんだー	エコーサウンダー	名詞	maritime-terms	
えーじゅうゆ	A重油	名詞	maritime-terms	
えすけーぷとらんく	エスケープトランク	名詞	maritime-terms	
えすだぶるえる	SWL	名詞	maritime-terms	
えだくたー	エダクター	名詞	maritime-terms	
えぬけーせん	NK船	名詞	maritime-terms	
えぷろん	エプロン	名詞	maritime-terms	
えまるじょんか	エマルジョン化	名詞	maritime-terms	
えむぜろ	エムゼロ	名詞	maritime-terms	
えるぴーじーせん	LPG船	名詞	maritime-terms	
えろーじょん	エロージョン	名詞	maritime-terms	
えんかいくいき	沿海区域	名詞	maritime-terms	
えんかいしかく	沿海資格	名詞	maritime-terms	
えんかくせいぎょ	遠隔制御	名詞	maritime-terms	
えんがんこうほう	沿岸航法	名詞	maritime-terms	
えんぎり	縁切	名詞	maritime-terms	
えんざい	縁材	名詞	maritime-terms	
えんじんてれぐらふ	エンジンテレグラフ	名詞	maritime-terms	
えんようくいき	遠洋区域	名詞	maritime-terms	
おいるふぇんす	オイルフェンス	名詞	maritime-terms	
おいるたいとはっち	オイルタイトハッチ	名詞	maritime-terms	
おきしゅうり	沖修理	名詞	maritime-terms	
おきにやく	沖荷役	名詞	maritime-terms	
おつなか	乙仲	名詞	maritime-terms	
おーばーふろーかん	オーバーフロー管	名詞	maritime-terms	
おーばーりっち	オーバーリッチ	名詞	maritime-terms	
おーばるけいりゅうりょうけい	オーバル型流量計	名詞	maritime-terms	
おふせっといべんと	オフセットベント	名詞	maritime-terms	
おふはいやー	オフハイヤー	名詞	maritime-terms	
おぺれーしょんまにゅある	オペレーションマニュアル	名詞	maritime-terms	
おぺれーたー	オペレーター	名詞	maritime-terms	
おもかじ	面舵	名詞	maritime-terms	
おんきょうそくしんぎ	音響測深儀	名詞	maritime-terms	
おんどかんざんけいすう	温度換算係数	名詞	maritime-terms	
おんはいやー	オンハイヤー	名詞	maritime-terms	
かいいん	海員	名詞	maritime-terms	
かいがんせん	海岸線	名詞	maritime-terms	
かいぎめんじょう	海技免状	名詞	maritime-terms	
がいこうせん	外航船	名詞	maritime-terms	
かいじくらすたー	海事クラスター	名詞	maritime-terms	
かいじせいさんせいかくめい	海事生産性革命	名詞	maritime-terms	
かいじょうこうつうあんぜんほう	海上交通安全法	名詞	maritime-terms	
かいじょうしうんてん	海上試運転	名詞	maritime-terms	
かいじょうしょうとつよぼうほう	海上衝突予防法	名詞	maritime-terms	
かいじょうほけん	海上保険	名詞	maritime-terms	
かいじょうろうどうじょうやく	海上労働条約	名詞	maritime-terms	
かいず	海図	名詞	maritime-terms	
かいすいのひじゅう	海水の比重	名詞	maritime-terms	
かいずのかいほ	海図の改補	名詞	maritime-terms	
かいなんきゅうじょ	海難救助	名詞	maritime-terms	
かいなんほうこくしょ	海難報告書	名詞	maritime-terms	
がいはん	外板	名詞	maritime-terms	
がいはんてんかいず	外板展開図	名詞	maritime-terms	
かいようおせんぼうしじょうやく	海洋汚染防止条約	名詞	maritime-terms	
かいようせいぶつふちゃくぼうしざい	海洋生物付着防止剤	名詞	maritime-terms	
かいり	海里	名詞	maritime-terms	
かいりゅう	海流	名詞	maritime-terms	
がうじんぐ	ガウジング	名詞	maritime-terms	
かきゅうき	過給機	名詞	maritime-terms	
かくへき	隔壁	名詞	maritime-terms	
かこうはんえん	可航半円	名詞	maritime-terms	
かーご	カーゴ	名詞	maritime-terms	
かさいあんぜんせつびのためのこくさいこーど	火災安全設備のための国際コード	名詞	maritime-terms	
かさいしけんほうのてききょうにかんするこくさいこーど	火災試験法の適用に関する国際コード	名詞	maritime-terms	
かさいせいぎょず	火災制御図	名詞	maritime-terms	
かし	華氏	名詞	maritime-terms	
がすけっと	ガスケット	名詞	maritime-terms	
かすけーどたんく	カスケードタンク	名詞	maritime-terms	
かすけーどりよう	カスケード利用	名詞	maritime-terms	
がすけんちき	ガス検知器	名詞	maritime-terms	
がすたーびん	ガスタービン	名詞	maritime-terms	
がすふりー	ガスフリー	名詞	maritime-terms	
かたじめ	片締め	名詞	maritime-terms	
かっぷりんぐ	カップリング	名詞	maritime-terms	
かへんぴっちぷろぺら	可変ピッチプロペラ	名詞	maritime-terms	
かぼたーじゅせいど	カボタージュ制度	名詞	maritime-terms	
かめいこくせいふ	加盟国政府	名詞	maritime-terms	
かもつかいじょうほけん	貨物海上保険	名詞	maritime-terms	
かもつゆかんそうち	貨物油管装置	名詞	maritime-terms	
からーちぇっく	カラーチェック	名詞	maritime-terms	
かりせんぱくこくせきしょうしょ	仮船舶国籍証書	名詞	maritime-terms	
かりばーす	仮バース	名詞	maritime-terms	
かんげん	乾舷	名詞	maritime-terms	
かんせいとしょ	完成図書	名詞	maritime-terms	
かんてんぼうき	観天望気	名詞	maritime-terms	
かんどっく	乾ドック	名詞	maritime-terms	
きかん	機関	名詞	maritime-terms	
きかんしつぜんごたんかくへき	機関室前後端隔壁	名詞	maritime-terms	
きかんとうちょく	機関当直	名詞	maritime-terms	
きかんせいぎょ	機関制御	名詞	maritime-terms	
きかんにっし	機関日誌	名詞	maritime-terms	
ききゅうていし	危急停止	名詞	maritime-terms	
きけんはんえん	危険半円	名詞	maritime-terms	
きけんぶつばらづみせん	危険物ばら積船	名詞	maritime-terms	
きけんよちとれーにんぐ	危険予知トレーニング	名詞	maritime-terms	
きこう	起工	名詞	maritime-terms	
きこく	旗国	名詞	maritime-terms	
ぎそう	艤装	名詞	maritime-terms	
きっすい	喫水	名詞	maritime-terms	
きっすいせいげんせん	喫水制限船	名詞	maritime-terms	
きてき	汽笛	名詞	maritime-terms	
きどうべん	起動弁	名詞	maritime-terms	
きのうじゅみょう	機能寿命	名詞	maritime-terms	
ぎゃくてんき	逆転機	名詞	maritime-terms	
ぎゃくてんそうち	逆転装置	名詞	maritime-terms	
きゃびてーしょん	キャビテーション	名詞	maritime-terms	
きゃんばー	キャンバー	名詞	maritime-terms	
きょうていうんちん	協定運賃	名詞	maritime-terms	
ぎょうてつ	撓鉄	名詞	maritime-terms	
きょうどうかいそん	共同海損	名詞	maritime-terms	
きょうどうかいそんぎせいそんがい	共同海損犠牲損害	名詞	maritime-terms	
きょうどうかいそんひよう	共同海損費用	名詞	maritime-terms	
きゅうめいふかん	救命浮環	名詞	maritime-terms	
きゅうめいどうい	救命胴衣	名詞	maritime-terms	
きゅうめいどういとう	救命胴衣灯	名詞	maritime-terms	
きょうゆうけんぞうせいど	共有建造制度	名詞	maritime-terms	
きょじゅうく	居住区	名詞	maritime-terms	
きょだいせん	巨大船	名詞	maritime-terms	
ぎょろうにじゅうじしているせんぱく	漁ろうに従事している船舶	名詞	maritime-terms	
ぎょろうせん	漁ろう船	名詞	maritime-terms	
きりしんごう	霧信号所	名詞	maritime-terms	
きんかいせん	近海船	名詞	maritime-terms	
きんきゅうゆそうていしぼたん	緊急送油停止ボタン	名詞	maritime-terms	
きんく	キンク	名詞	maritime-terms	
きんぐすとんばるぶ	キングストンバルブ	名詞	maritime-terms	
きんびょう	近錨	名詞	maritime-terms	
くうきあっしゅくき	空気圧縮機	名詞	maritime-terms	
くうきかんそうち	空気管装置	名詞	maritime-terms	
くうきていこう	空気抵抗	名詞	maritime-terms	
くうてん	空転	名詞	maritime-terms	
くえんちんぐすい	クエンチング水	名詞	maritime-terms	
くかくとそう	区画塗装	名詞	maritime-terms	
くりああんかー	クリアアンカー	名詞	maritime-terms	
くりあはいと	クリアハイト	名詞	maritime-terms	
ぐりすにっぷる	グリスニップル	名詞	maritime-terms	
くりーんばらすと	クリーンバラスト	名詞	maritime-terms	
ぐろすとん	グロストン	名詞	maritime-terms	
くろすほういほう	クロス方位法	名詞	maritime-terms	
けいかじゅうりょう	軽荷重量	名詞	maritime-terms	
けいざいじゅみょう	経済寿命	名詞	maritime-terms	
けいざいてきじゅみょう	経済的寿命	名詞	maritime-terms	
けいしゃしけん	傾斜試験	名詞	maritime-terms	
けいせんさくのあい	係船索のアイ	名詞	maritime-terms	
けいせんちゅうのせんぱく	係船中の船舶	名詞	maritime-terms	
けいせんさく	係船索	名詞	maritime-terms	
けいせんぶい	係船浮標	名詞	maritime-terms	
けいど	経度	名詞	maritime-terms	
けっじあんかー	ケッジアンカー	名詞	maritime-terms	
けーぷさいず	ケープサイズ	名詞	maritime-terms	
けみかるせん	ケミカル船	名詞	maritime-terms	
けれん	ケレン	名詞	maritime-terms	
げんあつさぎょう	減圧作業	名詞	maritime-terms	
けんえきほう	検疫法	名詞	maritime-terms	
けんさせいせきひょう	検査成績表	名詞	maritime-terms	
げんしょう	舷墻	名詞	maritime-terms	
げんしりょくきかん	原子力機関	名詞	maritime-terms	
けんすい	検水	名詞	maritime-terms	
げんそくそうち	減速装置	名詞	maritime-terms	
けんびょう	検錨	名詞	maritime-terms	
けんぺらーほーすこいるだうん	ケンペラーホースコイルダウン	名詞	maritime-terms	
こういえきめんけいほう	高位液面警報	名詞	maritime-terms	
こうかいきょりひょう	航海距離表	名詞	maritime-terms	
こうかいけいかく	航海計画	名詞	maritime-terms	
こうかいすじ	航海筋	名詞	maritime-terms	
こうかいそくりょく	航海速力	名詞	maritime-terms	
こうかいとう	航海灯	名詞	maritime-terms	
こうかいにっし	航海日誌	名詞	maritime-terms	
こうかいようかいず	航海用海図	名詞	maritime-terms	
こうかいようせん	航海用船	名詞	maritime-terms	
こうかいようでんしかいず	航海用電子海図	名詞	maritime-terms	
こうかいれき	航海暦	名詞	maritime-terms	
こうこうくいき	航行区域	名詞	maritime-terms	
こうせんこうぞうきてい	鋼船構造規程	名詞	maritime-terms	
こうぞくきょり	航続距離	名詞	maritime-terms	
こうそくほう	港則法	名詞	maritime-terms	
こうちょう	港長	名詞	maritime-terms	
こうちょう	高潮	名詞	maritime-terms	
こうちょうりょくこう	高張力鋼	名詞	maritime-terms	
こうとう	紅灯	名詞	maritime-terms	
こうないくいき	港内水域	名詞	maritime-terms	
こうはくず	港泊図	名詞	maritime-terms	
こうはん	甲板	名詞	maritime-terms	
こうはんちょうそうこ	甲板長倉庫	名詞	maritime-terms	
こうひ	港費	名詞	maritime-terms	
こうむかんとく	工務監督	名詞	maritime-terms	
こうもん	閘門	名詞	maritime-terms	
こうろし	航路誌	名詞	maritime-terms	
こーてぃんぐせん	コーティング船	名詞	maritime-terms	
こがたせん	小型船	名詞	maritime-terms	
こくさいあんぜんかんりこーど	国際安全管理コード	名詞	maritime-terms	
こくさいかいじきかん	国際海事機関	名詞	maritime-terms	
こくさいきゅうめいせつびこーど	国際救命設備コード	名詞	maritime-terms	
こくさいきょてんこうわん	国際拠点港湾	名詞	maritime-terms	
こくさいこうかい	国際航海	名詞	maritime-terms	
こくさいしんごうしょ	国際信号書	名詞	maritime-terms	
こくさいせんぱくせいど	国際船舶制度	名詞	maritime-terms	
こくさいせんりゃくこうわん	国際戦略港湾	名詞	maritime-terms	
こくさいそうとんすう	国際総トン数	名詞	maritime-terms	
こくさいぶいえいちえふ	国際VHF	名詞	maritime-terms	
こくさいろうどうきかん	国際労働機関	名詞	maritime-terms	
こくさいゆだくほしょうききん	国際油濁補償基金	名詞	maritime-terms	
こくゆ	黒油	名詞	maritime-terms	
ごさそくてい	誤差測定	名詞	maritime-terms	
こっくびる	コックビル	名詞	maritime-terms	
こーすあげーん	コースアゲーン	名詞	maritime-terms	
こていぴっちぷろぺら	固定ピッチプロペラ	名詞	maritime-terms	
こふぁだむ	コファダム	名詞	maritime-terms	
こーみんぐ	コーミング	名詞	maritime-terms	
こむさーる	コムサール	名詞	maritime-terms	
こりじょおんまっと	コリジョオンマット	名詞	maritime-terms	
こんじょうせん	混乗船	名詞	maritime-terms	
こんすたんと	コンスタント	名詞	maritime-terms	
こんたみ	コンタミ	名詞	maritime-terms	
こんぱすろーず	コンパスローズ	名詞	maritime-terms	
こんぱにおん	コンパニオン	名詞	maritime-terms	
さいかじゅうりょうとんすう	載貨重量トン数	名詞	maritime-terms	
さいきはんしゃざい	再帰反射材	名詞	maritime-terms	
さいだいきっすい	最大喫水	名詞	maritime-terms	
ざいりょうしけん	材料試験	名詞	maritime-terms	
さいだいしゅんかんふうそく	最大瞬間風速	名詞	maritime-terms	
さいだいふうそく	最大風速	名詞	maritime-terms	
さいだいとうさいじんいん	最大とう載人員	名詞	maritime-terms	
さいたんていしきょり	最短停止距離	名詞	maritime-terms	
さいどきーるそん	サイドキールソン	名詞	maritime-terms	
さいやーけんせん	SIRE検船	名詞	maritime-terms	
さうんでぃんぐぱいぷ	サウンディングパイプ	名詞	maritime-terms	
さきぶね	先船	名詞	maritime-terms	
さぎんぐ	サギング	名詞	maritime-terms	
さくしょんらいん	サクションライン	名詞	maritime-terms	
さげしお	下げ潮	名詞	maritime-terms	
さげん	左舷	名詞	maritime-terms	
さしあいせん	差合船	名詞	maritime-terms	
さびどめぺいんと	錆止めペイント	名詞	maritime-terms	
さぷらいちぇーん	サプライチェーン	名詞	maritime-terms	
さぶすたんだーどせん	サブスタンダード船	名詞	maritime-terms	
ささーちあんどれすきゅーじょうやく	サーチアンドレスキュー条約	名詞	maritime-terms	
さーべやー	サーベヤー	名詞	maritime-terms	
さんあらい	酸洗い	名詞	maritime-terms	
さんかくなみ	三角波	名詞	maritime-terms	
さんしょり	酸処理	名詞	maritime-terms	
さんそのうど	酸素濃度	名詞	maritime-terms	
さんどぶらすと	サンドブラスト	名詞	maritime-terms	
さんどれっど	サンドレッド	名詞	maritime-terms	
さんばし	桟橋	名詞	maritime-terms	
しーあんかー	シーアンカー	名詞	maritime-terms	
しおまち	潮待ち	名詞	maritime-terms	
しーじゅうゆ	C重油	名詞	maritime-terms	
しーばーす	シーバース	名詞	maritime-terms	
じきこんぱす	磁気コンパス	名詞	maritime-terms	
しこうせつだん	支綱切断	名詞	maritime-terms	
じこけんまとりょう	自己研磨塗料	名詞	maritime-terms	
じこてんかとう	自己点火灯	名詞	maritime-terms	
じこはつえんしんごう	自己発煙信号	名詞	maritime-terms	
しさこしょう	指差呼称	名詞	maritime-terms	
じさ	自差	名詞	maritime-terms	
じさ	時差	名詞	maritime-terms	
しかいせいげんじょうたい	視界制限状態	名詞	maritime-terms	
しっぷりさいくるじょうやく	シップリサイクル条約	名詞	maritime-terms	
してい	視程	名詞	maritime-terms	
じどうかさいたんちそうち	自動火災探知装置	名詞	maritime-terms	
じどうかせつび	自動化設備	名詞	maritime-terms	
じどうしょうとつよぼうえんじょそうち	自動衝突予防援助装置	名詞	maritime-terms	
じどうせいぎょ	自動制御	名詞	maritime-terms	
じどうそうだそうち	自動操舵装置	名詞	maritime-terms	
じぷしーほいーる	ジプシーホイール	名詞	maritime-terms	
しむけち	仕向地	名詞	maritime-terms	
しむけこう	仕向港	名詞	maritime-terms	
しやー	シヤー	名詞	maritime-terms	
じゃいろこんぱす	ジャイロコンパス	名詞	maritime-terms	
しゃせん	社船	名詞	maritime-terms	
じゅうごうぼうしざい	重合防止剤	名詞	maritime-terms	
しゅうぜんひ	修繕費	名詞	maritime-terms	
しゅーぴーす	シューピース	名詞	maritime-terms	
しゅうびょう	収錨	名詞	maritime-terms	
しゅうようよていじんいん	収容予定人員	名詞	maritime-terms	
しゅうり	修理	名詞	maritime-terms	
しゅき	主機	名詞	maritime-terms	
しゅどうかさいけいほうそうち	手動火災警報装置	名詞	maritime-terms	
しゅんかんふうそく	瞬間風速	名詞	maritime-terms	
じゅんしせいど	巡視制度	名詞	maritime-terms	
じゅんそう	順走	名詞	maritime-terms	
じゅんとんすう	純トン数	名詞	maritime-terms	
しょうえねせん	省エネ船	名詞	maritime-terms	
じょうか	上架	名詞	maritime-terms	
じょうきたーびん	蒸気タービン	名詞	maritime-terms	
じょうきむし	蒸気蒸し	名詞	maritime-terms	
しょうきゃくひ	償却費	名詞	maritime-terms	
しょうとつよぼうのためのこくさいきそくにかんするじょうやく	衝突の予防のための国際規則に関する条約	名詞	maritime-terms	
じょうようしゅつりょく	常用出力	名詞	maritime-terms	
しょじょこうかい	処女航海	名詞	maritime-terms	
しょっとぶらすとしょり	ショットブラスト処理	名詞	maritime-terms	
じょせんしゃわー	除染シャワー	名詞	maritime-terms	
しりんぐらだー	シリングラダー	名詞	maritime-terms	
しんかいとうびょうほう	深海投錨法	名詞	maritime-terms	
しんぐるはる	シングルハル	名詞	maritime-terms	
しんすい	進水	名詞	maritime-terms	
しんほうい	真方位	名詞	maritime-terms	
すいせんかんちょう	垂線間長	名詞	maritime-terms	
すいそうしけん	水槽試験	名詞	maritime-terms	
すいへいぺいんと	水線ペイント	名詞	maritime-terms	
すいみつかくへき	水密隔壁	名詞	maritime-terms	
すいみつとびら	水密扉	名詞	maritime-terms	
すいろし	水路誌	名詞	maritime-terms	
すいろずし	水路図誌	名詞	maritime-terms	
すいろつうほう	水路通報	名詞	maritime-terms	
すーぱーえこしっぷ	スーパーエコシップ	名詞	maritime-terms	
すきじゃく	隙尺	名詞	maritime-terms	
すかっぱー	スカッパー	名詞	maritime-terms	
すくらばー	スクラバー	名詞	maritime-terms	
すけーるてーぷ	スケールテープ	名詞	maritime-terms	
すたびらいざー	スタビライザー	名詞	maritime-terms	
すちふな	スチフナ	名詞	maritime-terms	
すてんれすせん	ステンレス船	名詞	maritime-terms	
すとりっぴんぐぽんぷ	ストリッピングポンプ	名詞	maritime-terms	
すたんすらすたー	スタンスラスター	名詞	maritime-terms	
すとれーなー	ストレーナー	名詞	maritime-terms	
すぴるたんく	スピルタンク	名詞	maritime-terms	
すぺっくひょう	スペック表	名詞	maritime-terms	
すらいむ	スライム	名詞	maritime-terms	
すらっじ	スラッジ	名詞	maritime-terms	
すらみんぐ	スラミング	名詞	maritime-terms	
すりっぷちゅーぶ	スリップチューブ	名詞	maritime-terms	
するーかーご	スルーカーゴ	名詞	maritime-terms	
すろっしんぐしょうげきあつ	スロッシング衝撃圧	名詞	maritime-terms	
せいげんきあつ	スロップタンク制限気圧	名詞	maritime-terms	
せいさく	静索	名詞	maritime-terms	
せいじょうき	清浄機	名詞	maritime-terms	
せいすい	清水	名詞	maritime-terms	
せいび	整備	名詞	maritime-terms	
せかいきしょうきかん	世界気象機関	名詞	maritime-terms	
せきさいようせきとんすう	載貨容積トン数	名詞	maritime-terms	
せきにんとんすう	責任トン数	名詞	maritime-terms	
せつがん	接岸	名詞	maritime-terms	
せっし	摂氏	名詞	maritime-terms	
せとり	瀬取り	名詞	maritime-terms	
せわたし	瀬渡し	名詞	maritime-terms	
せんいんてちょう	船員手帳	名詞	maritime-terms	
せんいんのさいがいほけんせいど	船員の災害保険制度	名詞	maritime-terms	
せんいんひ	船員費	名詞	maritime-terms	
せんいんほう	船員法	名詞	maritime-terms	
せんいんほけんせいど	船員保険制度	名詞	maritime-terms	
せんいんろうむかん	船員労務官	名詞	maritime-terms	
せんがんき	洗眼器	名詞	maritime-terms	
せんきゅう	船級	名詞	maritime-terms	
せんきょう	船橋	名詞	maritime-terms	
せんきゅうしょうしょ	船級証書	名詞	maritime-terms	
せんきょうとうちょく	船橋当直	名詞	maritime-terms	
せんこうぎそう	先行艤装	名詞	maritime-terms	
せんこうせん	専航船	名詞	maritime-terms	
せんこく	船殻	名詞	maritime-terms	
せんしゅ	船主	名詞	maritime-terms	
せんしゅ	船首	名詞	maritime-terms	
せんしゅかくへき	船首隔壁	名詞	maritime-terms	
せんしゅすいそう	船首水槽	名詞	maritime-terms	
せんしゅせきにんそうごほけん	船主責任相互保険	名詞	maritime-terms	
せんじょうとうしすてむ	洗浄塔システム	名詞	maritime-terms	
せんせきこう	船籍港	名詞	maritime-terms	
せんそう	船艙	名詞	maritime-terms	
せんたいのけいざいてきじゅみょう	船体の経済的寿命	名詞	maritime-terms	
せんちょう	船長	名詞	maritime-terms	
せんたいていこう	船体抵抗	名詞	maritime-terms	
せんだいしんすい	船台進水	名詞	maritime-terms	
せんだんりょく	剪断力	名詞	maritime-terms	
ぜんちょう	全長	名詞	maritime-terms	
せんていとりょう	船底塗料	名詞	maritime-terms	
せんていべん	船底弁	名詞	maritime-terms	
せんないじゅんしせいど	船内巡視制度	名詞	maritime-terms	
せんないしょしつ	船内諸室	名詞	maritime-terms	
せんぱく	船舶	名詞	maritime-terms	
せんぱくかしわたしぎょう	船舶貸渡業	名詞	maritime-terms	
せんぱくかんりがいしゃ	船舶管理会社	名詞	maritime-terms	
せんぱくかんりにん	船舶管理人	名詞	maritime-terms	
せんぱくきかんきそく	船舶機関規則	名詞	maritime-terms	
せんぱくきゅうめいせつびきそく	船舶救命設備規則	名詞	maritime-terms	
せんぱくきょうゆうしゃ	船舶共有者	名詞	maritime-terms	
せんぱくくかくきそく	船舶区画規程	名詞	maritime-terms	
せんぱくけんさかん	船舶検査官	名詞	maritime-terms	
せんぱくけんさしょうしょ	船舶検査証書	名詞	maritime-terms	
せんぱくけんさてちょう	船舶検査手帳	名詞	maritime-terms	
せんぱくこくせきしょうしょ	船舶国籍証書	名詞	maritime-terms	
せんぱくじどうかせつびとくしゅきそく	船舶自動化設備特殊規則	名詞	maritime-terms	
せんぱくじどうしきべつそうち	船舶自動識別装置	名詞	maritime-terms	
せんぱくしょうぼうせつびきそく	船舶消防設備規則	名詞	maritime-terms	
せんぱくしょくいん	船舶職員	名詞	maritime-terms	
せんぱくしょくいんほう	船舶職員法	名詞	maritime-terms	
せんぱくせつびきてい	船舶設備規程	名詞	maritime-terms	
せんぱくちんしゃくにん	船舶賃借人	名詞	maritime-terms	
せんぱくのとんすうそくどにかんするこくさいじょうやく	船舶のトン数測度に関する国際条約	名詞	maritime-terms	
せんぱくばんごう	船舶番号	名詞	maritime-terms	
せんび	船尾	名詞	maritime-terms	
せんびかくへき	船尾隔壁	名詞	maritime-terms	
せんびかん	船尾管	名詞	maritime-terms	
せんびすいそう	船尾水槽	名詞	maritime-terms	
せんぷく	船腹	名詞	maritime-terms	
せんぱくほう	船舶法	名詞	maritime-terms	
せんぱくぼうかこうぞうきそく	船舶防火構造規則	名詞	maritime-terms	
せんぱくほけん	船舶保険	名詞	maritime-terms	
せんぱくほけんりょう	船舶保険料	名詞	maritime-terms	
せんめいふじ	船名符字	名詞	maritime-terms	
せんようひんひ	船用品費	名詞	maritime-terms	
せんれい	船齢	名詞	maritime-terms	
そうぎこういのせいげん	争議行為の制限	名詞	maritime-terms	
そうじゅうせいのうせいげんせん	操縦性能制限船	名詞	maritime-terms	
ぞうそくき	増速機	名詞	maritime-terms	
そうたいほう	相対方位	名詞	maritime-terms	
そうとんすう	総トン数	名詞	maritime-terms	
そうどうせん	双胴船	名詞	maritime-terms	
ぞうはていこう	造波抵抗	名詞	maritime-terms	
そうびょう	走錨	名詞	maritime-terms	
そくしんかん	測深管	名詞	maritime-terms	
そくしんぎ	測深儀	名詞	maritime-terms	
そくりょく	速力	名詞	maritime-terms	
そのたじょうせんしゃ	その他乗船者	名詞	maritime-terms	
だーてぃーばらすと	ダーティーバラスト	名詞	maritime-terms	
だいあふらむ	ダイアフラム	名詞	maritime-terms	
たいすいそくりょく	対水速力	名詞	maritime-terms	
たいせんりょう	滞船料	名詞	maritime-terms	
だいたいけんぞう	代替建造	名詞	maritime-terms	
たいちそくりょく	対地速力	名詞	maritime-terms	
だいちょう	大潮	名詞	maritime-terms	
だいちょうしょう	大潮昇	名詞	maritime-terms	
だいりてん	代理店	名詞	maritime-terms	
たいりゅうすい	滞留水	名詞	maritime-terms	
だかくしじき	舵角指示器	名詞	maritime-terms	
たぐぼーと	タグボート	名詞	maritime-terms	
たちいかり	立錨	名詞	maritime-terms	
たっきんぐ	タッキング	名詞	maritime-terms	
だぶりんぐぷれーと	ダブリングプレート	名詞	maritime-terms	
だぶるしゃっと	ダブルシャット	名詞	maritime-terms	
だぶるはる	ダブルハル	名詞	maritime-terms	
たりふ	タリフ	名詞	maritime-terms	
だりん	舵輪	名詞	maritime-terms	
たんくくりーにんぐ	タンククリーニング	名詞	maritime-terms	
たんくくりーにんぐさーべい	タンククリーニングサーベイ	名詞	maritime-terms	
たんこうかい	短航海	名詞	maritime-terms	
たんこうせい	堪航性	名詞	maritime-terms	
たんどくかいそん	単独海損	名詞	maritime-terms	
ちぇーんすとっぱー	チェーンストッパー	名詞	maritime-terms	
ちぇーんろっかー	チェーンロッカー	名詞	maritime-terms	
ちちゅう	踟躊	名詞	maritime-terms	
ちっそさんかぶつ	窒素酸化物	名詞	maritime-terms	
ちっそぱーじ	窒素パージ	名詞	maritime-terms	
ちゃくさん	着桟	名詞	maritime-terms	
ちゃくさんさんげんそく	着桟3原則	名詞	maritime-terms	
ちゃーたーべーす	チャーターベース	名詞	maritime-terms	
ちゅうかんけんさ	中間検査	名詞	maritime-terms	
ちょうかいけん	懲戒権	名詞	maritime-terms	
ちょうけいべん	蝶形弁	名詞	maritime-terms	
ちょうこう	潮高	名詞	maritime-terms	
ちょうさ	潮差	名詞	maritime-terms	
ちょうせきひょう	潮汐表	名詞	maritime-terms	
ちょうりゅう	潮流	名詞	maritime-terms	
ちょくせんきせん	直線基線	名詞	maritime-terms	
ちょっこうちゃくさん	直航着桟	名詞	maritime-terms	
ちょっさー	チョッサー	名詞	maritime-terms	
ついせきりゅう	追跡流	名詞	maritime-terms	
つうかつうこうけん	通過通航権	名詞	maritime-terms	
つうせん	通船	名詞	maritime-terms	
つなとり	綱取り	名詞	maritime-terms	
つなはなし	綱放し	名詞	maritime-terms	
つみにえやく	積み荷役	名詞	maritime-terms	
であいかく	出会い角	名詞	maritime-terms	
ていきけんさ	定期検査	名詞	maritime-terms	
ていきせん	定期船	名詞	maritime-terms	
ていきようせん	定期用船	名詞	maritime-terms	
でぃすぽーざー	ディスポーザー	名詞	maritime-terms	
ていちょう	低潮	名詞	maritime-terms	
ていちょう	停潮	名詞	maritime-terms	
でぃーぜるきかん	ディーゼル機関	名詞	maritime-terms	
でぃーぷたんく	ディープタンク	名詞	maritime-terms	
でぃーぷたんくかくへき	ディープタンク隔壁	名詞	maritime-terms	
でっきすたんど	デッキスタンド	名詞	maritime-terms	
てじまい	手仕舞	名詞	maritime-terms	
てすり	手摺	名詞	maritime-terms	
でっどうぇいと	デッドウェイト	名詞	maritime-terms	
でっどしっぷじょうたい	デッドシップ状態	名詞	maritime-terms	
てばたしんごう	手旗信号	名詞	maritime-terms	
でふね	出船	名詞	maritime-terms	
でぼとる	デボトル	名詞	maritime-terms	
でまれっじ	デマレッジ	名詞	maritime-terms	
でりばりーおーだー	デリバリーオーダー	名詞	maritime-terms	
でりばりーらいん	デリバリーライン	名詞	maritime-terms	
てんそくれき	天測暦	名詞	maritime-terms	
てんしょく	点食	名詞	maritime-terms	
てんもんこうほう	天文航法	名詞	maritime-terms	
でんじすいしん	電磁推進	名詞	maritime-terms	
でんぱこうほう	電波航法	名詞	maritime-terms	
てんまど	天窓	名詞	maritime-terms	
どうざく	動索	名詞	maritime-terms	
とうしんせん	等深線	名詞	maritime-terms	
とうだい	灯台	名詞	maritime-terms	
とうだいひょう	灯台表	名詞	maritime-terms	
どうとう	導灯	名詞	maritime-terms	
とうふひょう	灯浮標	名詞	maritime-terms	
とくしゅばしょ	特殊場所	名詞	maritime-terms	
とくたんせん	特タン船	名詞	maritime-terms	
とくていこう	特定港	名詞	maritime-terms	
とくべつけんさ	特別検査	名詞	maritime-terms	
どっく	ドック	名詞	maritime-terms	
どっくれしーと	ドックレシート	名詞	maritime-terms	
とっぷへびー	トップヘビー	名詞	maritime-terms	
ともあらい	共洗い	名詞	maritime-terms	
どらいかーご	ドライカーゴ	名詞	maritime-terms	
どらいどっく	ドライドック	名詞	maritime-terms	
どらいばるくせん	ドライバルク船	名詞	maritime-terms	
どらふとまーく	ドラフトマーク	名詞	maritime-terms	
とらまーく	トラマーク	名詞	maritime-terms	
とりかじ	取り舵	名詞	maritime-terms	
とりっぷうんちん	トリップ運賃	名詞	maritime-terms	
とりっぷせん	トリップ船	名詞	maritime-terms	
とりむ	トリム	名詞	maritime-terms	
どるふぃんばーす	ドルフィンバース	名詞	maritime-terms	
どれん	ドレン	名詞	maritime-terms	
どろっぷらいん	ドロップライン	名詞	maritime-terms	
どんごろす	ドンゴロス	名詞	maritime-terms	
ないこうせん	内航船	名詞	maritime-terms	
ないこうせんぱくかしわたしぎょう	内航船舶貸渡業	名詞	maritime-terms	
ないねんきかん	内燃機関	名詞	maritime-terms	
なぎ	凪	名詞	maritime-terms	
なふさ	ナフサ	名詞	maritime-terms	
なぐてっくすじゅしんき	ナブテックス受信機	名詞	maritime-terms	
にじゅうてい	二重底	名詞	maritime-terms	
にじゅうはんてんぷろぺら	二重反転プロペラ	名詞	maritime-terms	
にじゅうべん	二重弁	名詞	maritime-terms	
にっこうしんごうきょう	日光信号鏡	名詞	maritime-terms	
にほんせんぱく	日本船舶	名詞	maritime-terms	
にやくかんりしつ	荷役管理室	名詞	maritime-terms	
にやくかんりひょう	荷役管理表	名詞	maritime-terms	
にやくきょうてい	荷役協定	名詞	maritime-terms	
にやくきょうていしょ	荷役協定書	名詞	maritime-terms	
にやくさぎょう	荷役作業	名詞	maritime-terms	
にゅうか	乳化	名詞	maritime-terms	
にゅうこうりょう	入港料	名詞	maritime-terms	
にんいあいえすえむ	任意ISM	名詞	maritime-terms	
にんいかくざ	任意擱座	名詞	maritime-terms	
ねつかそせいじゅし	熱可塑性樹脂	名詞	maritime-terms	
ねつこうかせいじゅし	熱硬化性樹脂	名詞	maritime-terms	
ねつこうかんき	熱交換器	名詞	maritime-terms	
ねんりょうゆ	燃料油	名詞	maritime-terms	
のっと	ノット	名詞	maritime-terms	
のづみ	野積	名詞	maritime-terms	
のりあげどっく	乗揚げドック	名詞	maritime-terms	
のりくみいん	乗組員	名詞	maritime-terms	
はーねす	ハーネス	名詞	maritime-terms	
はいあらーむ	ハイアラーム	名詞	maritime-terms	
はいがすえこのまいざー	排ガスエコノマイザー	名詞	maritime-terms	
ばいざすたん	バイザスタン	名詞	maritime-terms	
ばいざへっど	バイザヘッド	名詞	maritime-terms	
ばいすばろっとのほうそく	バイスバロットの法則	名詞	maritime-terms	
はいたてきけいざいすいいき	排他的経済水域	名詞	maritime-terms	
はいせん	配船	名詞	maritime-terms	
はいやーべーす	ハイヤーベース	名詞	maritime-terms	
ばうすらすたー	バウスラスター	名詞	maritime-terms	
ばうだうんとりむ	バウダウントリム	名詞	maritime-terms	
はくち	泊地	名詞	maritime-terms	
ばくはつげんかい	爆発限界	名詞	maritime-terms	
ばくろこうはん	暴露甲板	名詞	maritime-terms	
はくゆ	白油	名詞	maritime-terms	
ばーす	バース	名詞	maritime-terms	
ぱーせるたんかー	パーセルタンカー	名詞	maritime-terms	
はだかようせん	裸用船	名詞	maritime-terms	
ばたふらいべん	バタフライ弁	名詞	maritime-terms	
ばたわーすましん	バタワースマシン	名詞	maritime-terms	
はだんけいすう	破断係数	名詞	maritime-terms	
はちまきせん	鉢巻船	名詞	maritime-terms	
はちゅうりょく	把駐力	名詞	maritime-terms	
はっかてん	発火点	名詞	maritime-terms	
ぱっきん	パッキン	名詞	maritime-terms	
はっこうまえのけんさ	発航前の検査	名詞	maritime-terms	
はっち	ハッチ	名詞	maritime-terms	
はなぎり	端切り	名詞	maritime-terms	
ばらすと	バラスト	名詞	maritime-terms	
ばらすとすいかんりじょうやく	バラスト水管理条約	名詞	maritime-terms	
ばらすとのこうか	バラストの効果	名詞	maritime-terms	
ばらづみ	バラ積み	名詞	maritime-terms	
ばりき	馬力	名詞	maritime-terms	
ばるくへっど	バルクヘッド	名詞	maritime-terms	
ばるばすばう	バルバスバウ	名詞	maritime-terms	
ばんかー	バンカー	名詞	maritime-terms	
ばんかーさーちゃーじ	バンカーサーチャージ	名詞	maritime-terms	
ばんぎ	盤木	名詞	maritime-terms	
ぱんちんぐ	パンチング	名詞	maritime-terms	
ばんちんぐこうぞう	パンチング構造	名詞	maritime-terms	
はんどれっど	ハンドレッド	名詞	maritime-terms	
はんようせん	汎用船	名詞	maritime-terms	
ぴーあいほけん	PI保険	名詞	maritime-terms	
ひーびんぐらいん	ヒービングライン	名詞	maritime-terms	
ぴーぷほーる	ピープホール	名詞	maritime-terms	
びーむ	ビーム	名詞	maritime-terms	
ひきあげせんだい	引揚げ船台	名詞	maritime-terms	
ぴぐおし	ピグ押し	名詞	maritime-terms	
ひけんせん	避険線	名詞	maritime-terms	
ひこうせん	避航船	名詞	maritime-terms	
ひこうどうさ	避航動作	名詞	maritime-terms	
ひじゅう	比重	名詞	maritime-terms	
びーしゅせん	Ｂ種船	名詞	maritime-terms	
ひじょうよういちしじむせんひょうしきそうち	非常用位置指示無線標識装置	名詞	maritime-terms	
ひじょうだっしゅつこきゅうぐ	非常脱出呼吸具	名詞	maritime-terms	
ひじょうていし	非常停止	名詞	maritime-terms	
ぴっちぽーりんぐ	ピッチポーリング	名詞	maritime-terms	
ぴっちんぐ	ピッチング	名詞	maritime-terms	
びっと	ビット	名詞	maritime-terms	
ひなんこう	避難港	名詞	maritime-terms	
ひはかいけんさ	非破壊検査	名詞	maritime-terms	
ひやりはっと	ヒヤリハット	名詞	maritime-terms	
ひょうちゅう	漂躊	名詞	maritime-terms	
ひらあし	平脚	名詞	maritime-terms	
びるじ	ビルジ	名詞	maritime-terms	
びるじかんそうち	ビルジ管装置	名詞	maritime-terms	
びるじうえる	ビルジウエル	名詞	maritime-terms	
びるじきーる	ビルジキール	名詞	maritime-terms	
ひろうきょうど	疲労強度	名詞	maritime-terms	
ふぁいやーわいやー	ファイヤーワイヤー	名詞	maritime-terms	
ふぁうるあんかー	ファウルアンカー	名詞	maritime-terms	
ふぁっしょんぷれーと	ファッションプレート	名詞	maritime-terms	
ふぁんねるまーく	ファンネルマーク	名詞	maritime-terms	
ぶい	浮標	名詞	maritime-terms	
ぶいん	部員	名詞	maritime-terms	
ふういん	封印	名詞	maritime-terms	
ふうそく	風速	名詞	maritime-terms	
ぷーぷだうん	プープダウン	名詞	maritime-terms	
ふぇありーだー	フェアリーダー	名詞	maritime-terms	
ふぉあぴーくたんく	フォアピークタンク	名詞	maritime-terms	
ふぉーすまじゅーるじょうこう	フォースマジュール条項	名詞	maritime-terms	
ふかどうそんしつほけん	不稼動損失保険	名詞	maritime-terms	
ふきながし	吹流し	名詞	maritime-terms	
ふくげんせい	復元性	名詞	maritime-terms	
ふくげんりょく	復元力	名詞	maritime-terms	
ぶつりじゅみょう	物理寿命	名詞	maritime-terms	
ふていきせん	不定期船	名詞	maritime-terms	
ふなじゃく	船尺	名詞	maritime-terms	
ふなにしょうけん	船荷証券	名詞	maritime-terms	
ぷらかーど	プラカード	名詞	maritime-terms	
ぶらっくあうと	ブラックアウト	名詞	maritime-terms	
ふらっぷらだー	フラップラダー	名詞	maritime-terms	
ふらんじ	フランジ	名詞	maritime-terms	
ぶりざーべん	ブリザー弁	名詞	maritime-terms	
ぶるわーく	ブルワーク	名詞	maritime-terms	
ぶれーきはんどる	ブレーキハンドル	名詞	maritime-terms	
ふれーむ	フレーム	名詞	maritime-terms	
ふれーむあれすたー	フレームアレスター	名詞	maritime-terms	
ふれーむなんばー	フレームナンバー	名詞	maritime-terms	
ふれすとばるぶ	フレストバルブ	名詞	maritime-terms	
ふれっしゅうぉーたー	フレッシュウォーター	名詞	maritime-terms	
ふれとめびょう	振れ止め錨	名詞	maritime-terms	
ふれんどふぃん	フレンドフィン	名詞	maritime-terms	
ぶろーちんぐ	ブローチング	名詞	maritime-terms	
ぶろっくけんぞうほう	ブロック式建造法	名詞	maritime-terms	
ふろーてぃんぐどっく	フローティングドック	名詞	maritime-terms	
ふろーてぃんぐるーふたんく	フローティングルーフタンク	名詞	maritime-terms	
ぷろぺら	プロペラ	名詞	maritime-terms	
ぶんかい	分解	名詞	maritime-terms	
へいきんふうそく	平均風速	名詞	maritime-terms	
へいしばん	閉止板	名詞	maritime-terms	
へいすいくいき	平水区域	名詞	maritime-terms	
べーぱーはいかん	べーパー配管	名詞	maritime-terms	
べるぶっく	ベルブック	名詞	maritime-terms	
べるまうす	ベルマウス	名詞	maritime-terms	
べんぎちせきせん	便宜置籍船	名詞	maritime-terms	
へんしん	変針	名詞	maritime-terms	
へんしんてん	変針点	名詞	maritime-terms	
へんさ	偏差	名詞	maritime-terms	
べんとかん	ベント管	名詞	maritime-terms	
ぼうかこうぞう	防火構造	名詞	maritime-terms	
ぼうげんざい	防舷材	名詞	maritime-terms	
ほうこうぞく	芳香族	名詞	maritime-terms	
ぼうしょくあえんばん	防食亜鉛板	名詞	maritime-terms	
ぼーすんちぇあ	ボースンチェア	名詞	maritime-terms	
ぽーとすてーとこんとろーる	ポートステートコントロール	名詞	maritime-terms	
ぼうちょうしききゅうめいいかだ	膨張式救命筏	名詞	maritime-terms	
ぼうちょうとらんく	膨張トランク	名詞	maritime-terms	
ほき	補機	名詞	maritime-terms	
ほぎんぐ	ホギング	名詞	maritime-terms	
ほじせん	保持船	名詞	maritime-terms	
ほしん	保針	名詞	maritime-terms	
ぼーすんすとあ	ボースンストア	名詞	maritime-terms	
ほぜい	保税	名詞	maritime-terms	
ぼーとだびっと	ボートダビット	名詞	maritime-terms	
ぼらーど	ボラード	名詞	maritime-terms	
ほんせんかんぱんわたしじょうけん	本船甲板渡し条件	名詞	maritime-terms	
ぼんでぃんぐ	ボンディング	名詞	maritime-terms	
まいあにゅーすれたー	マイアニュースレター	名詞	maritime-terms	
まいる	マイル	名詞	maritime-terms	
まえにきせい	前荷規制	名詞	maritime-terms	
まぐねとろん	マグネトロン	名詞	maritime-terms	
まえぶね	前船	名詞	maritime-terms	
まぐねてぃっくこんぱす	マグネティックコンパス	名詞	maritime-terms	
まーちす	マーチス	名詞	maritime-terms	
まにほーるど	マニホールド	名詞	maritime-terms	
まりーんくれーん	マリーンクレーン	名詞	maritime-terms	
まるきぶね	丸木船	名詞	maritime-terms	
まるとも	丸艫	名詞	maritime-terms	
まるぼいらー	丸ボイラー	名詞	maritime-terms	
まるまど	丸窓	名詞	maritime-terms	
まんさいきっすいせん	満載喫水線	名詞	maritime-terms	
まんさいきっすいしんきそく	満載喫水線規則	名詞	maritime-terms	
まんさいきっすいせんにかんするこくさいじょうやく	満載喫水線に関する国際条約	名詞	maritime-terms	
まんせんかざり	満船飾	名詞	maritime-terms	
みかけすうりょう	見掛数量	名詞	maritime-terms	
みじっぷ	ミジップ	名詞	maritime-terms	
みずきり	水切り	名詞	maritime-terms	
みずさきく	水先区	名詞	maritime-terms	
みずさきにん	水先人	名詞	maritime-terms	
みつど	密度	名詞	maritime-terms	
みっぺいにやく	密閉荷役	名詞	maritime-terms	
むありんぐうぃんち	ムアリングウィンチ	名詞	maritime-terms	
むがいつうこうけん	無害通航権	名詞	maritime-terms	
むせんでんわ	無線電話	名詞	maritime-terms	
むちゅうしんごう	霧中信号	名詞	maritime-terms	
めんどり	面取り	名詞	maritime-terms	
もーだるしふと	モーダルシフト	名詞	maritime-terms	
もやいさくはっしゃき	もやい索発射器	名詞	maritime-terms	
やといいれけいやく	雇入契約	名詞	maritime-terms	
ゆうがいえきたいおせんぼうしきんきゅうそちてびきしょ	やまじ風有害液体汚染防止緊急措置手引書	名詞	maritime-terms	
ゆうがいえきたいぶっしつきろくぼ	有害液体物質記録簿	名詞	maritime-terms	
ゆうげんせきにんじぎょうくみあい	有限責任事業組合	名詞	maritime-terms	
ゆうがいぼうおほうほうきせいじょうやく	有害防汚方法規制条約	名詞	maritime-terms	
ゆすいぶんりき	油水分離器	名詞	maritime-terms	
ゆそうせん	油槽船	名詞	maritime-terms	
ゆそうせん	油送船	名詞	maritime-terms	
ゆだくぼうしきんきゅうそちてびきしょ	油濁防止緊急措置手引書	名詞	maritime-terms	
よーいんぐ	ヨーイング	名詞	maritime-terms	
ようせん	用船	名詞	maritime-terms	
ようせんけいやく	傭船契約	名詞	maritime-terms	
ようびょうき	揚錨機	名詞	maritime-terms	
よこもち	横持ち	名詞	maritime-terms	
よびせんいん	予備船員	名詞	maritime-terms	
よゆうすいしん	余裕水深	名詞	maritime-terms	
よんきゅっきゅっう	499船	名詞	maritime-terms	
らいんふらっしんぐ	ラインフラッシング	名詞	maritime-terms	
らっとがーど	ラットガード	名詞	maritime-terms	
らんぷさむけいやく	ランプサム契約	名詞	maritime-terms	
りーくてすと	リークテスト	名詞	maritime-terms	
りーさいど	リーサイド	名詞	maritime-terms	
りがんきょり	離岸距離	名詞	maritime-terms	
りがんりゅう	離岸流	名詞	maritime-terms	
りきっどかーご	リキッドカーゴ	名詞	maritime-terms	
りくかぜ	陸風	名詞	maritime-terms	
りぐなむばいた	リグナムバイタ	名詞	maritime-terms	
りべっと	リベット	名詞	maritime-terms	
りむかかく	RIM価格	名詞	maritime-terms	
りゅうこつ	竜骨	名詞	maritime-terms	
りゅうそく	流速	名詞	maritime-terms	
りゅうでんようきょくぼうしょくほう	流電陽極防食法	名詞	maritime-terms	
りょうばつきてい	両罰規定	名詞	maritime-terms	
りょくとう	緑灯	名詞	maritime-terms	
りんじこうこうきょかしょう	臨時航行許可証	名詞	maritime-terms	
りんじこうこうけんさ	臨時航行検査	名詞	maritime-terms	
りんじとうにゅうせん	臨時投入船	名詞	maritime-terms	
るーぷそうき	ループ掃気	名詞	maritime-terms	
れすぽんしぶるけあ	レスポンシブルケア	名詞	maritime-terms	
れっこー	レッコー	名詞	maritime-terms	
れっと	レット	名詞	maritime-terms	
れでゅーさー	レデューサー	名詞	maritime-terms	
れーしんぐ	レーシング	名詞	maritime-terms	
れーだー	レーダー	名詞	maritime-terms	
れーだーとらんすぽんだ	レーダートランスポンダ	名詞	maritime-terms	
れぴーたーこんぱす	レピーターコンパス	名詞	maritime-terms	
れべるげーじ	レベルゲージ	名詞	maritime-terms	
れんぞくさいだいしゅつりょく	連続最大出力	名詞	maritime-terms	
ろーりんぐ	ローリング	名詞	maritime-terms	
ろーずぼっくす	ローズボックス	名詞	maritime-terms	
ろーでぃんぐあーむ	ローディングアーム	名詞	maritime-terms	
ろくぶんぎ	六分儀	名詞	maritime-terms	
わっち	ワッチ	名詞	maritime-terms	
わんきょくぶりゅうこつ	湾曲部竜骨	名詞	maritime-terms	
ふめん	浮面	名詞	maritime-terms	
ふめんしん	浮面心	名詞	maritime-terms	
せんてい	船底	名詞	maritime-terms	
かいぎし	海技士	名詞	maritime-terms	
かいしょう	海象	名詞	maritime-terms	
ようせんしゃ	傭船者	名詞	maritime-terms	
じせん	自船	名詞	maritime-terms	
たせん	他船	名詞	maritime-terms	
りちゃくさん	離着桟	名詞	maritime-terms	
りさん	離桟	名詞	maritime-terms	
こうこうせん	航行船	名詞	maritime-terms	


